NO ./text/wall_2.xpm
SO ./text/0.xpm
WE ./text/collectibles_2.xpm
EA ./text/wall.xpm

F 0,255,0
C 255,255,255

1111111111111111111111111
1000000000110000000000001
10110000011000000000000011
10010000000000000000000001
100000S0000000000000000011
1000000000000000000000001
1000000100000000000000001
1000000111111111111111111
10000001
10000001
10000001
11000001
11110111
11111111