NO ../assets/wall1.xpm
SO ../assets/wall2.xpm
WE ../assets/wall3.xpm
EA ../assets/wall_fire.xpm
DR ../assets/0.xpm

F 128,128,128
C 39,127,193

        1111111111111111111111111
        1000000000110000000000001
        1011000001110000000000001
        1001000000050000000000001
111111111011000001110000000000001
100000000011000001111111115111111
11110111111111011100000010001
11110111111111011101010010001
11000000110101011100000050001
10000000000000001100000011011
10000000000000001101010010001
11000001110101011111011110N01
11110111 1110101 101111011011
11111111 1111111 111111110001
                        11111